16 96
111111111111111111111111111111111111111111111111111111111111111111111111111111111111111111111111
100000000000122210000000000012221000000000001222100000000000122210000000000012221000000000001222
100000000000133310000000000012221000000000001222100000000000122210000000000012221000000000001222
100000000000144410000000000012221000000000001222100000000000122210000000000012221000000000001222
100000000000123410000000000012221000000000001222100000000000122210002222000012221000000000001222
100000000000123410000000000012221000000000001222100000000000122210000000000012221000000000001222
100000000000112310000000000012221000000000001222100000000000122210000000000012221000000000001222
100000000000143210000000000012221000000000001222100000000000122210000000000012221000000000001222
000000000000000000000000000000000000000000000000000000000000000000000000000000000000000000000000
000000000000000000000000000000000000000000000000000000000000000000000000000000000000000000000000
000000000000000000000111100000000000000000000000000000000000000000000000000000000000000000000000
000000000000000000000000000000000000000000000000000000000000000000000000000000000000000000000000
000000000000003000000000000000000001111110000000000011111111111110000000000000000000000000000000
0000000000000030000000000000000000000000000000000000000000000000000000000000000000000000000000000
000000000000000000000000000000000000000000000000000000000000000000000000000000000000000000000000
111111111111111111111111111111111111111111111111111111111111111111111111111111111111111111111111
9 13
1111111111111
1000000000001
1000000000001
1000000000001
1111111111111
1000000000001
1000000000001
1000000000001
1111111111111