14 146
b444444444444444444444444411111b4444444c1111111111b4444c11b444c1111b44444444444c11111b444444444c1b44444444444c1b444444c1b444444c1b4444444444444444
3000000000000000000000000084c1130000000511111111113000051130005111130000000000051111130000000005130000000000051300000084700000051300000000000000f0
3000000000000000000000000000511300000005111111111130000511300051111300000000000511b447000000009db70000000000051300000000000000051300000000000000f0
300000000000000000000000000084c3000000051111111111300005113000844447000000000005b470000000000051300000000000084700000000000000051300000000000000f0
3000000000000000000000000000005300000005111111144c3000051130000000000000000000053000000000000051300000000000000000000000000000084700000000000000f0
3000000000000000000000000000005300000005111114700530000511300000000000000000000530000000000009db700000000000000000000092600000000000000092600000f0
300000000000000000000000000000530000000511b47000053000051130000000000000000000087000000000000513000000096000000000000051300000000000000051300000f0
3000000000000000000000000000008700000005b47000000530000844700000000000009260000000000000000005b70000009d3000092600000051300000000000000051300000f0
300000000000000000000000000000000000000870000000053000000000000000000000513000000000000000009d30000009db7000051300000051300000092600000051300000f0
300000000000000000960000000000000000000000000000087000000000000000000922d1a222222226000000005b7000009d130000051300000051300000051300000051300000f0
30000000000000000053000000000000000000000000000000000000000000000000051111111111111a600000008700000051b70000051300000051300000051300000084700000f0
3000000000000000005a260000000000000000000096000000000000000926000000084444444444444ca600000000000009d1300000051300000051300000051300000000000000f0
30000000000000000051130000000000000000000053000000092226000513000000000000000000000513000000000000051b700000051300000051300000051300000000000000f0
a22222222222222222d11a22222222222222222222da2222222d111a222d1a222222222222222222222d1a222222222222d11a2222222d1a222222d1a222222d1a2222222222222222
