15 288
4444444444444444444444444444444444444444444444444444444444444444444444444444444c11b44444444444444444444444444444444444444444444444444444444444444444444444444444444444444444444c11b44444444444444444444444444444444444444444444444444444444444444444444444444444444444444444444c11b4444444444444
000000000000000000000000000000000000000000000000000000000000000000000000000000051130000000000000000000000000000000000000000000000000000000000000000000000000000000000000000000051130000000000000000000000000000000000000000000000000000000000000000000000000000000000000000000051130000000000000
000000000000000000000000000000000000000000000000000000000000000000000000000000051130000000000000000000000000000000000000000000000000000000000000000000000000000000000000000000051130000000000000000000000000000000000000000000000000000000000000000000000000000000000000000000051130000000000000
000000000000000000000922222226000000000000000000000000009600000000000000000000084470000000000000000000000000000000000922222226000000000000000000000000009600000000000000000000084470000000000000000000000000000000000922222226000000000000000000000000009600000000000000000000084470000000000000
000000000000000000000844444447000000000000000000000000008700000000000000000000000000000000000000000000000000000000000844444447000000000000000000000000008700000000000000000000000000000000000000000000000000000000000844444447000000000000000000000000008700000000000000000000000000000000000000
000000000000000000000000000000000000000000000000000000000000000000000000000000000000000000000000000000000000000000000000000000000000000000000000000000000000000000000000000000000000000000000000000000000000000000000000000000000000000000000000000000000000000000000000000000000000000000000000
000000922222226000000000000000000000000000000000000000000000000000000000000000000000000000000000000000922222226000000000000000000000000000000000000000000000000000000000000000000000000000000000000000922222226000000000000000000000000000000000000000000000000000000000000000000000000000000000
000000511111113000000000000000000000000000000000000000000000000000000000000000000000000000000000000000511111113000000000000000000000000000000000000000000000000000000000000000000000000000000000000000511111113000000000000000000000000000000000000000000000000000000000000000000000000000000000
000000844444447000000000000000000000000000000000000000000000000000009600000000000000000000000000000000844444447000000000000000000000000000000000000000000000000000009600000000000000000000000000000000844444447000000000000000000000000000000000000000000000000000009600000000000000000000000000
000000000000000000000000000000000000000000000000000000000000000000008700000000000000000000000000000000000000000000000000000000000000000000000000000000000000000000008700000000000000000000000000000000000000000000000000000000000000000000000000000000000000000000008700000000000000000000000000
000000000000000000000000000000000000000000000922260000000000000000000000000000000000000000000000000000000000000000000000000000000000000000000922260000000000000000000000000000000000000000000000000000000000000000000000000000000000000000000922260000000000000000000000000000000000000000000000
000000000000000000000000000000000000000000000511130000000000000000000000000000009222222260000000000000000000000000000000000000000000000000000511130000000000000000000000000000009222222260000000000000000000000000000000000000000000000000000511130000000000000000000000000000009222222260000000
000000000000000000000000000000000000000000000511130000000000000000000000000000005111111130000000000000000000000000000000000000000000000000000511130000000000000000000000000000005111111130000000000000000000000000000000000000000000000000000511130000000000000000000000000000005111111130000000
000000000000000000000000000000000000000000000511130000000000000000000000000000008444444470000000000000000000000000000000000000000000000000000511130000000000000000000000000000008444444470000000000000000000000000000000000000000000000000000511130000000000000000000000000000008444444470000000
222222222222222222222222222222222222222222222d111a2222222222222222222222222222222222222222222222222222222222222222222222222222222222222222222d111a2222222222222222222222222222222222222222222222222222222222222222222222222222222222222222222d111a2222222222222222222222222222222222222222222222
9 13
1111111111111
1000000000001
1000000000001
1000000000001
1111111111111
1000000000001
1000000000001
1000000000001
1111111111111