14 20
b4444444444444444444
3000000000000000000f
3000000000000000000f
3000000000000000000f
3000000000000000000f
3000000000000000000f
3000000000000000000f
3000000000000000000f
3000000000000000000f
3000000000000000000f
3000000000000000000f
3000000000000000000f
3000000000000000000f
a2222222222222222222