14 20
b4444444444444444444
30000000000000000000
30000000000000000000
30000000100000000000
30000000000001000000
30000000000100000000
30000000000100000000
30000000100000000000
30000000100001000000
30000000011111000000
30000000000000000000
30000000000000000000
30000000000000000000
a2222222222222222222